000000000
011111110
001111100
001121100
001111100
011111110
000000000