1310000000000000
1111110111111110
0000110000000110
0110111111111110
0110000000000110
0111111111111110
0110111110000000
0110112110111110
0000111110110110
0111111111110110
0000000000000000