1110000000000000
1111110111111110
0000110000000110
0110111111111110
0110000000000110
0111110111111110
0110110110000000
0110111110111110
0000110110110110
0111110111110110
0000000000000110