000000000000000
000110111111110
000110000000110
000111111111110
000110000000110
000110111111110
000110110000000
000111110111110
000110110110110
000110111110110
000000000000011